10
20
####################
#I              ## #
# ### ######## ### #
# ###    ####      #
##### ## ###########
#     ## ###     ###
########     ### ###
################ ###
S                ###
####################